XXXXXXXXXXXXXXXXXXXXXX
X!OOOOOOOXXOOOOOXXOO!X
XOXOXXXXOOOOXXXOOOOXOX
XOXOOOXXOXXOXXXOXXXXOX
XOXXXOXOOOOOOOOOOOOOOX
XOOOXOXOXOXXXOXXOXXXOX
XXXOXOOOOOOOOOXXOXXXOX
XXXOXXXXOXXXXXXXOXOOOX
XXOOOOOOOXXXXXXXOOOXOX
XXOXOXXXOXXXXXXXXXXXOX
XXOXOOOOOXXOOOXXXXXXOX
XOOXOXXXXXXOXOOOOOOOOX
XOXXOOOOOOOOXXXXXOXXOX
XOXXOXXXXOXXXXXXOOXXOX
XOOOOXXXOOOOOOOOOXXXOX
XOXXXXXOOXXOXXXXXXOOOX
XOOXOOOOXXOOOOOOOOOXXX
XXOXOXXOOOOXXOXXXXOXXX
XOOOOXXOXXXXXOXXXXOXXX
XOXOXXXOOOOXXOOOOO!XXX
X@OOOOOOXX!OOOXXXXXXXX
XXXXXXXXXXXXXXXXXXXXXX