XXXXXXXXXXXX
XOOOOOOOOOOX
XOXXXOXOXXOX
XOOOOOXOOXOX
XOXXXOXXOXOX
XOXOOOXOOOOX
XOOOXOOOXXOX
XOXXXOXXXXOX
XOOOOOXOOOOX
XOXXXXXOXXOX
XOOOOOOOOOOX
XXXXXXXXXXXX